________________________________________
|--------------------------------------|
|--------------------------------------|
|--------------------------------------|
|--------------------------------------|
|--------------------------------------|
|--------------------------------------|
|------------------H-------------------|
|----------------*****-----------------|
|------------****----------------------|
|----------***-------------------------|
|--------***---------------------------|
|-------**-----------------------------|
|-------**-----------------------------|
|-------**-----------------------------|
|--------***---------M-----------------|
|----------***-------------------------|
|------------****----------------------|
|----------------*****-----------------|
|---------------------****-------------|
|-------------------------***----------|
|----------------------------**--------|
|----------------------------**--------|
|----------------------------**--------|
|-------------------------***----------|
|-----------------------***------------|
|----------------M--****---------------|
|--------------*****-------------------|
|--------------------------------------|
|--------------------------------------|
|--------------------------------------|
|--------------------------------------|
|--------------------------------------|
****************************************
0123456789 12345678  87654321 9876543210 (use this row for symmetrical design)
When constructing world:
	Avoid tunnels (floor and ceiling are one unit apart)
	Avoid pits (walls are one unit apart)
	Spawn the hero at least one unit above the floor